{
  "name": "MF34",
  "vendorProductId": 441667409,
  "macros": ["", "", "", "", "", "", "", "", "", "", "", "", "", "", "", ""],
  "layers": [
    [
      "KC_PSCR",
      "MO(4)",
      "A(KC_PSCR)",
      "KC_TRNS",
      "KC_TRNS",
      "KC_CALC",
      "KC_BSPC",
      "KC_INS",
      "KC_HOME",
      "KC_PGUP",
      "KC_F10",
      "KC_F11",
      "KC_F12",
      "KC_PMNS",
      "KC_DEL",
      "KC_END",
      "KC_PGDN",
      "KC_F7",
      "KC_F8",
      "KC_F9",
      "KC_NO",
      "KC_NO",
      "KC_NO",
      "KC_NO",
      "KC_F4",
      "KC_F5",
      "KC_F6",
      "KC_PPLS",
      "KC_NO",
      "KC_UP",
      "KC_NO",
      "KC_F1",
      "KC_F2",
      "KC_F3",
      "KC_NO",
      "KC_LEFT",
      "KC_DOWN",
      "KC_RGHT",
      "KC_NO",
      "KC_TRNS",
      "KC_TRNS",
      "KC_PENT"
    ],
    [
      "KC_TRNS",
      "KC_TRNS",
      "KC_TRNS",
      "KC_TRNS",
      "KC_TRNS",
      "KC_TRNS",
      "KC_TRNS",
      "KC_TRNS",
      "KC_TRNS",
      "KC_TRNS",
      "KC_TRNS",
      "KC_TRNS",
      "KC_TRNS",
      "KC_TRNS",
      "KC_TRNS",
      "KC_TRNS",
      "KC_TRNS",
      "KC_TRNS",
      "KC_TRNS",
      "KC_TRNS",
      "KC_TRNS",
      "KC_TRNS",
      "KC_TRNS",
      "KC_TRNS",
      "KC_TRNS",
      "KC_TRNS",
      "KC_TRNS",
      "KC_TRNS",
      "KC_TRNS",
      "KC_TRNS",
      "KC_TRNS",
      "KC_TRNS",
      "KC_TRNS",
      "KC_TRNS",
      "KC_TRNS",
      "KC_TRNS",
      "KC_TRNS",
      "KC_TRNS",
      "KC_TRNS",
      "KC_TRNS",
      "KC_TRNS",
      "KC_TRNS"
    ],
    [
      "KC_TRNS",
      "KC_TRNS",
      "KC_TRNS",
      "KC_TRNS",
      "KC_TRNS",
      "KC_TRNS",
      "KC_TRNS",
      "KC_TRNS",
      "KC_TRNS",
      "KC_TRNS",
      "KC_TRNS",
      "KC_TRNS",
      "KC_TRNS",
      "KC_TRNS",
      "KC_TRNS",
      "KC_TRNS",
      "KC_TRNS",
      "KC_TRNS",
      "KC_TRNS",
      "KC_TRNS",
      "KC_TRNS",
      "KC_TRNS",
      "KC_TRNS",
      "KC_TRNS",
      "KC_TRNS",
      "KC_TRNS",
      "KC_TRNS",
      "KC_TRNS",
      "KC_TRNS",
      "KC_TRNS",
      "KC_TRNS",
      "KC_TRNS",
      "KC_TRNS",
      "KC_TRNS",
      "KC_TRNS",
      "KC_TRNS",
      "KC_TRNS",
      "KC_TRNS",
      "KC_TRNS",
      "KC_TRNS",
      "KC_TRNS",
      "KC_TRNS"
    ],
    [
      "KC_TRNS",
      "KC_TRNS",
      "KC_TRNS",
      "KC_TRNS",
      "KC_TRNS",
      "KC_TRNS",
      "RESET",
      "RGB_TOG",
      "RGB_HUI",
      "RGB_MOD",
      "KC_TRNS",
      "KC_TRNS",
      "KC_TRNS",
      "KC_TRNS",
      "KC_TRNS",
      "RGB_HUD",
      "RGB_RMOD",
      "KC_TRNS",
      "KC_TRNS",
      "KC_TRNS",
      "KC_NO",
      "KC_NO",
      "KC_NO",
      "KC_NO",
      "KC_TRNS",
      "KC_TRNS",
      "KC_TRNS",
      "KC_TRNS",
      "KC_NO",
      "RGB_VAI",
      "KC_NO",
      "KC_TRNS",
      "KC_TRNS",
      "KC_TRNS",
      "KC_NO",
      "RGB_SPD",
      "RGB_VAD",
      "RGB_SPI",
      "KC_NO",
      "KC_TRNS",
      "KC_TRNS",
      "QK_CLEAR_EEPROM"
    ]
  ],
  "encoders": []
}